10002220111000222001110020002010
10000200100102000201001020002010
10000200100102000001001002020010
10000200100102000001001002020010
10000200111002000001001000200010
10000200100102002201001002020010
10000200100102000201001002020010
10000200100102000201001020002000
11102220111000222001110020002010
66666666666666666666666666666666