04440004000444004444404444000400
40040040400400400040004004004040
00040040400400400040004004004040
44440400040444400040004444040004
00040444440400400040004000044444
40040400040400400040004000040004
04440400040444000040004000040004
00000000000000000000000000000000
00000000000000000000000000000000
00000000000000000000000000000000
33303003003330003000333303003003
30303033030030033300300003003003
30303033000030030300300003003003
30303333033330030300333303003003
30303303000030030300300003003003
30303303030030333330300003333000
30303003003330300030333300000303
00000000000000000000000000000000
00000000000000000000000000000000
00000000000000000000000000000000
