03330002220006660001110004440000
03330002220006660001110004440000
03330002220006660001110004440000
05550005550006560005550005550000
07770007770007770007770007770000
00004440001110006660002220003330
00004440001110006660002220003330
00004440001110006660002220003330
00005550005550005550005550005550
00007770007770007770007770007770