00555550000000123400000005555500
00077700000000234500000000777000
07716177000000345100000077363770
07761677000000451200000077636770
07716177000000512300000077363770
00077700000000000000000000777000
00000000000000000000000000000000
00555550000000000000000005555500
00077700000000000000000000777000
07726277000000000000000077464770
07762677000000000000000077646770
07726277000000000000000077464770
00077700000000000000000000777000