000003333300000000000033333000000
000035555530000000000355555300000
000354444453000000003544444530000
003544444445300000035444444453000
035444555444530000354445554445300
035444555444453333544445554445300
003544555444446666444445554453000
000354444444446666444444444530000
000035444444446666444444445300000
000003544444446666444444453000000
000000354444444444444444530000000
000000035444444444444445300000000
000000003544444444444453000000000
000000000354444444444530000000000
000000000035444444445300000000000
000000000003544444453000000000000
000000000000354444530000000000000
000000000000035555300000000000000
000000000000003333000000000000000
000000000000000000000000000000000