00000000000000044000000000000000
00000000000000333300000000000000
00000000000002266220000000000000
00000000000011166111000000000000
00000000000444466444400000000000
00000000003333366333330000000000
00000000022222266222222000000000
00000000111111166111111100000000
00000004444444466444444440000000
00000033333333366333333333000000
00000222222222266222222222200000
00001111111111166111111111110000
00044444444444466444444444444000
00333333333333366333333333333300
02222222222222266222222222222220
11111111111111166111111111111111
00000000000000000000000000000000
00000000000000000000000000000000
00000000000000000000000000000000
00000000000000000000000000000000