06660000000000777777000000006660
06260000000011445544110000006260
06660000000144445544441000006660
00000000001444445544444100000000
00000000014444445544444010000000
00000000014444445544444410000000
00000000124444445544444421000000
00000000123444445544444421000000
00000000123444445544444321000000
00000000123444445544444321000000
00000000123444445544444321000000
00000000123444445544444321000000
00000000123444445544444321000000
00000000124444445544444421000000
00000000014444445544444410000000
00000000014444445544444410000000
00000000001444445544444100000000
06660000000144445544441000006660
06260000000011445544110000006260
06660000000000777777000000006660