00000000000000000000000000000000
00000000000000000000000000000000
00011111111111117222222222222200
00011111111111117222222222222200
00011111111111117222222222222200
00011111111111117222222222222200
00011111111111117222222222222200
00011111111111117222222222222200
00011111111111667662222222222200
00011111111111667662222222222200
00077777777777777777777777777700
00033333333333667664444444444400
00033333333333667664444444444400
00033333333333337444444444444400
00033333333333337444444444444400
00033333333333337444444444444400
00033333333333337444444444444400
00033333333333337444444444444400
00033333333333337444444444444400
00000000000000000000000000000000