00000011111111111111111111000000
00000001111111111111111110000000
00000000111111111111111100000000
00000000011111111111111000000000
00000000001333333333310000000000
00000000000133333333100000000000
00000000000013333331000000000000
00000000000001333310000000000000
00000000000000133100000000000000
00000000000000133100000000000000
00000000000001133110000000000000
00000000000011133111000000000000
00000000000111133111100000000000
00000000001111133111110000000000
00000000011111133111111000000000
00000000133333333333333100000000
00000001333333333333333310000000
00000016161616161616161616000000
00000000000000000000000000000000
00000000000000000000000000000000